//MAP CONVERTED BY dmm2tgm.py THIS HEADER COMMENT PREVENTS RECONVERSION, DO NOT REMOVE
"a" = (
/turf/open/floor/plating/vampgrass,
/area/space)
"i" = (
/turf/open/floor/plating/sidewalk/poor,
/area/space)
"j" = (
/obj/machinery/light{
	dir = 1
	},
/turf/open/floor/plating/sidewalk/poor,
/area/space)
"m" = (
/obj/manholedown,
/turf/open/floor/plating/vampgrass,
/area/space)
"n" = (
/obj/structure/flora/ausbushes,
/turf/open/floor/plating/vampgrass,
/area/space)
"p" = (
/obj/structure/flora/ausbushes/lavendergrass,
/turf/open/floor/plating/vampgrass,
/area/space)
"r" = (
/obj/effect/decal/bordur,
/obj/effect/decal/bordur{
	dir = 9;
	icon_state = "border"
	},
/turf/open/floor/plating/sidewalk/poor,
/area/space)
"t" = (
/obj/structure/flora/ausbushes/sparsegrass,
/turf/open/floor/plating/vampgrass,
/area/space)
"u" = (
/obj/structure/flora/ausbushes/fullgrass,
/turf/open/floor/plating/vampgrass,
/area/space)
"v" = (
/turf/closed/wall/vampwall,
/area/space)
"w" = (
/obj/structure/flora/ausbushes/lavendergrass,
/obj/structure/big_vamprocks,
/turf/open/floor/plating/vampgrass,
/area/space)
"x" = (
/obj/effect/decal/bordur{
	dir = 1;
	icon_state = "border"
	},
/turf/open/floor/plating/sidewalk/poor,
/area/space)
"D" = (
/obj/structure/vampfence/rich{
	dir = 4;
	icon_state = "fence"
	},
/turf/open/floor/plating/vampgrass,
/area/space)
"E" = (
/obj/machinery/light{
	pixel_y = 32
	},
/turf/open/floor/plating/sidewalk/poor,
/area/space)
"G" = (
/obj/effect/decal/bordur{
	dir = 1;
	icon_state = "border"
	},
/obj/effect/decal/bordur{
	dir = 10
	},
/turf/open/floor/plating/sidewalk/poor,
/area/space)
"H" = (
/obj/structure/flora/ausbushes/sparsegrass,
/obj/structure/big_vamprocks,
/turf/open/floor/plating/vampgrass,
/area/space)
"J" = (
/obj/effect/decal/graffiti,
/turf/open/floor/plating/sidewalk/poor,
/area/space)
"K" = (
/obj/structure/big_vamprocks,
/turf/open/floor/plating/vampgrass,
/area/space)
"L" = (
/obj/structure/vamprocks,
/turf/open/floor/plating/vampgrass,
/area/space)
"M" = (
/turf/open/floor/plating/asphalt,
/area/space)
"O" = (
/obj/structure/vamptree/pine,
/turf/open/floor/plating/vampgrass,
/area/space)
"P" = (
/obj/effect/decal/bordur,
/turf/open/floor/plating/sidewalk/poor,
/area/space)
"R" = (
/obj/structure/flora/ausbushes/lavendergrass,
/obj/structure/small_vamprocks,
/turf/open/floor/plating/vampgrass,
/area/space)
"S" = (
/turf/closed/wall/vampwall/rock,
/area/space)
"T" = (
/obj/structure/small_vamprocks,
/turf/open/floor/plating/vampgrass,
/area/space)
"Y" = (
/obj/effect/decal/bordur,
/obj/effect/decal/bordur{
	dir = 1
	},
/turf/open/floor/plating/sidewalk/poor,
/area/space)
"Z" = (
/obj/effect/decal/bordur{
	dir = 1;
	icon_state = "border"
	},
/obj/effect/decal/bordur,
/turf/open/floor/plating/sidewalk/poor,
/area/space)

(1,1,1) = {"
a
a
a
a
a
a
a
a
a
a
a
a
a
a
a
a
a
a
a
a
a
a
a
a
a
a
a
a
a
a
a
a
a
a
a
a
a
a
a
a
a
a
a
a
a
a
a
a
a
a
a
v
i
P
M
M
x
i
v
a
a
a
a
a
a
a
a
a
a
a
a
a
S
S
S
a
a
a
a
a
"}
(2,1,1) = {"
S
S
S
S
a
a
a
a
a
a
a
a
a
S
S
S
a
a
a
a
a
a
a
a
a
a
a
a
a
a
a
a
a
a
a
a
a
a
S
S
S
S
S
a
a
a
a
a
a
a
a
v
J
P
M
M
x
i
v
a
a
S
S
S
S
S
a
S
S
S
a
S
S
a
S
S
S
a
a
a
"}
(3,1,1) = {"
S
a
a
S
S
S
S
a
a
S
S
S
S
S
a
S
S
S
a
a
S
S
S
a
a
a
a
a
a
S
S
S
a
a
a
a
S
S
S
a
a
a
S
S
a
a
a
S
S
S
a
v
E
P
M
M
x
j
v
a
S
S
S
a
a
S
S
S
a
S
S
S
a
a
a
a
S
S
a
a
"}
(4,1,1) = {"
S
a
a
a
a
a
S
S
S
S
a
a
a
a
a
a
a
S
S
S
S
a
S
S
S
S
a
S
S
S
a
S
S
a
S
S
S
a
a
a
a
a
a
S
S
S
S
S
a
S
S
v
v
P
M
M
x
v
v
S
S
a
a
a
a
a
a
a
a
a
a
a
a
a
a
a
a
S
S
S
"}
(5,1,1) = {"
S
a
a
a
a
a
a
a
a
a
a
a
a
a
a
a
a
a
a
a
a
a
a
a
a
S
S
S
a
a
a
a
S
S
S
a
a
a
a
a
a
a
a
a
v
a
S
a
a
a
a
a
a
Y
M
M
Z
a
a
a
a
a
a
a
a
a
a
a
a
a
a
a
a
a
a
a
a
a
a
S
"}
(6,1,1) = {"
S
a
a
a
a
a
a
a
a
a
a
a
a
a
a
a
a
a
a
a
a
O
a
a
a
t
O
a
a
a
a
a
a
a
a
a
a
a
a
a
a
a
a
a
D
a
a
a
a
a
a
a
a
Y
M
M
Z
a
a
a
a
a
a
a
a
a
a
a
a
a
a
a
a
a
a
a
a
a
a
S
"}
(7,1,1) = {"
S
a
a
a
a
a
a
a
a
a
a
a
a
a
a
a
n
u
a
t
a
t
a
a
u
a
a
a
p
p
a
a
a
a
a
a
T
a
t
a
a
a
a
a
D
a
a
a
a
a
a
a
a
Y
M
M
Z
a
a
a
a
a
a
a
a
a
a
a
a
a
a
a
a
a
a
a
a
a
S
S
"}
(8,1,1) = {"
S
a
a
a
a
a
a
a
a
a
a
a
a
a
a
a
a
p
t
O
a
a
a
a
a
a
u
a
a
a
u
a
a
u
a
a
n
a
a
a
a
a
a
a
D
a
a
a
a
a
a
a
a
Y
M
M
Z
a
a
a
a
a
a
a
a
a
a
a
a
a
a
a
a
a
a
a
a
a
S
a
"}
(9,1,1) = {"
S
a
a
a
a
a
a
a
a
a
a
a
a
a
a
a
a
p
a
a
a
p
p
a
a
a
a
a
a
a
a
a
a
a
a
O
a
n
T
a
a
a
a
a
D
a
a
a
a
a
a
a
a
Y
M
M
Z
a
a
a
a
a
a
a
a
a
a
a
a
a
a
a
a
a
a
a
a
a
S
a
"}
(10,1,1) = {"
S
a
a
a
a
a
a
a
a
a
a
a
a
a
a
a
a
p
a
u
a
a
a
u
a
a
a
a
a
n
u
a
O
a
a
a
a
u
a
a
a
a
a
a
D
a
a
a
a
a
a
a
a
Y
M
M
Z
a
a
a
a
a
a
a
a
a
a
a
a
a
a
a
a
a
a
a
a
a
S
S
"}
(11,1,1) = {"
S
a
a
a
a
a
a
a
a
a
a
a
a
a
a
a
p
a
a
a
a
a
a
a
a
a
t
a
a
a
T
a
a
a
a
p
a
a
a
a
a
a
a
a
D
a
a
a
a
a
a
a
a
Y
M
M
Z
a
a
a
a
a
a
a
a
a
a
a
a
a
a
a
a
a
a
a
a
a
a
S
"}
(12,1,1) = {"
S
a
a
a
a
a
a
a
a
a
a
a
a
a
a
a
a
a
a
a
a
a
n
u
a
t
a
a
a
a
a
L
a
a
t
a
a
a
p
a
a
a
a
a
D
a
a
a
a
a
a
a
a
Y
M
M
Z
a
a
a
a
a
a
a
a
a
a
a
a
a
a
a
a
a
a
a
a
a
S
S
"}
(13,1,1) = {"
S
S
a
a
a
a
a
a
a
a
a
a
a
a
a
a
a
u
a
t
a
a
a
T
a
O
a
a
a
a
a
K
u
a
t
t
a
a
a
a
a
a
a
a
D
a
a
a
a
a
a
a
a
Y
M
M
Z
a
a
a
a
a
a
a
a
a
a
a
a
a
a
a
a
a
a
a
a
a
S
a
"}
(14,1,1) = {"
a
S
S
S
S
a
a
a
a
a
a
a
a
a
a
a
a
a
t
a
a
a
a
a
L
a
a
a
u
a
T
a
a
a
a
a
a
O
a
a
a
a
a
a
D
a
a
a
a
a
a
a
a
Y
M
M
Z
a
a
a
a
a
a
a
a
a
a
a
a
a
a
a
a
a
a
a
a
a
S
a
"}
(15,1,1) = {"
a
a
a
a
S
a
a
a
a
a
a
a
a
a
a
a
n
a
O
a
a
a
a
a
K
a
a
a
a
t
a
a
a
O
p
a
a
a
L
a
a
a
a
a
D
a
a
a
a
a
a
a
a
Y
M
M
Z
a
a
a
a
a
a
a
a
a
a
a
a
a
a
a
a
a
a
a
a
a
S
a
"}
(16,1,1) = {"
a
a
a
a
S
a
a
a
a
a
a
a
a
a
a
a
p
a
a
a
a
u
a
T
a
a
n
a
O
t
a
p
a
a
a
a
u
u
a
a
a
a
a
a
D
a
a
a
a
a
a
a
a
Y
M
M
Z
a
a
a
a
a
a
a
a
a
a
a
a
a
a
a
a
a
a
a
a
S
S
a
"}
(17,1,1) = {"
a
a
a
a
S
a
a
a
a
a
a
a
a
a
a
a
t
a
a
a
a
a
t
a
a
a
O
p
a
a
a
L
a
a
a
a
a
a
a
a
a
a
a
a
D
a
a
a
a
a
a
a
a
Y
M
M
Z
a
a
a
a
a
a
a
a
a
a
a
a
a
a
a
a
a
a
a
a
S
a
a
"}
(18,1,1) = {"
a
a
a
S
S
a
a
a
a
a
a
a
a
a
a
a
a
a
a
n
a
O
t
a
p
a
a
a
a
u
u
a
K
a
a
t
a
O
u
a
a
a
a
a
D
a
a
a
a
a
a
a
a
Y
M
M
Z
a
a
a
a
a
a
a
a
a
a
a
a
a
a
a
a
a
a
a
a
S
a
a
"}
(19,1,1) = {"
a
a
a
S
a
a
a
a
a
a
a
a
a
a
a
a
a
a
R
a
a
a
a
a
a
a
u
a
a
a
a
T
a
a
T
t
a
a
u
a
a
a
a
a
D
a
a
a
a
a
a
a
a
Y
M
M
Z
a
a
a
a
a
a
a
a
a
a
a
a
a
a
a
a
a
a
a
a
S
a
a
"}
(20,1,1) = {"
a
a
S
S
a
a
a
a
a
a
a
a
a
a
a
a
a
u
a
a
a
a
n
a
a
a
a
a
O
a
a
a
a
p
a
a
u
a
a
a
a
a
a
a
D
a
a
a
a
a
a
a
a
Y
M
M
Z
a
a
a
a
a
a
a
a
a
a
a
a
a
a
a
a
a
a
a
a
a
a
a
"}
(21,1,1) = {"
a
a
S
a
a
a
a
a
a
a
a
a
a
a
a
a
a
a
a
a
O
a
a
a
a
a
a
a
a
a
a
a
a
a
a
a
a
a
a
a
a
a
a
a
D
a
a
a
a
a
a
a
a
Y
M
M
Z
a
a
a
a
a
a
a
a
a
a
a
a
a
a
a
a
a
a
a
a
a
a
a
"}
(22,1,1) = {"
a
a
S
a
a
a
a
a
a
a
a
a
a
a
a
a
a
a
t
a
t
a
a
a
a
a
a
a
a
a
a
a
a
a
a
a
a
a
a
a
a
a
a
a
D
a
a
a
a
a
a
a
a
Y
M
M
Z
a
a
a
a
a
a
a
a
a
a
a
a
a
a
a
a
a
a
a
a
a
a
a
"}
(23,1,1) = {"
a
S
S
a
a
a
a
a
a
a
a
a
a
a
a
a
a
t
O
a
a
a
a
a
a
a
a
a
a
a
a
t
a
a
a
a
a
a
a
a
a
a
a
a
D
a
a
a
a
a
a
a
a
Y
M
M
Z
a
a
a
a
a
a
a
a
a
a
a
a
a
a
a
a
a
a
a
a
a
a
a
"}
(24,1,1) = {"
a
S
a
a
a
a
a
a
a
a
a
a
a
a
a
a
a
a
a
a
p
p
a
a
a
a
a
a
T
a
t
a
a
a
a
t
a
t
t
a
a
a
a
a
D
a
a
a
a
a
a
a
a
Y
M
M
Z
a
a
a
a
a
a
a
a
a
a
a
a
a
a
a
a
a
a
a
a
a
a
a
"}
(25,1,1) = {"
a
S
a
a
a
a
a
a
a
a
a
a
a
a
a
a
a
a
u
a
a
a
u
a
a
u
a
a
n
a
a
K
L
a
u
O
a
a
a
a
a
a
a
a
D
a
a
a
a
a
a
a
a
Y
M
M
Z
a
a
a
a
a
a
a
a
a
a
a
a
a
a
a
a
a
a
a
a
a
a
a
"}
(26,1,1) = {"
a
S
a
a
a
a
a
a
a
a
a
a
a
a
a
a
t
a
a
a
a
a
a
a
a
a
a
O
a
n
T
a
a
a
u
u
a
a
a
a
a
a
a
a
D
a
a
a
a
a
a
a
a
Y
M
M
Z
a
a
a
a
a
a
a
a
a
a
a
a
a
a
a
a
a
a
a
a
a
a
a
"}
(27,1,1) = {"
a
S
S
a
a
a
a
a
a
a
a
a
a
a
a
a
t
a
a
m
a
n
u
a
O
a
a
a
a
u
a
a
u
a
a
a
a
a
a
a
a
a
a
a
D
a
a
a
a
a
a
a
a
Y
M
M
Z
a
a
a
a
a
a
a
a
a
a
a
a
a
a
a
a
a
a
a
a
a
a
a
"}
(28,1,1) = {"
a
a
S
a
a
a
a
a
a
a
a
a
a
a
a
a
a
a
t
a
a
a
T
a
a
a
a
p
a
a
a
a
a
a
a
a
t
t
a
a
a
a
a
a
D
a
a
a
a
a
a
a
a
Y
M
M
Z
a
a
a
a
a
a
a
a
a
a
a
a
a
a
a
a
a
a
a
a
a
a
a
"}
(29,1,1) = {"
a
a
S
a
a
a
a
a
a
a
a
a
a
a
a
a
a
t
a
a
a
a
a
L
a
a
t
a
a
a
p
a
a
O
a
t
a
a
a
a
a
a
a
a
D
a
a
a
a
a
a
a
a
Y
M
M
Z
a
a
a
a
a
a
a
a
a
a
a
a
a
a
a
a
a
a
a
a
a
a
a
"}
(30,1,1) = {"
a
a
S
a
a
a
a
a
a
a
a
a
a
a
a
a
u
O
a
a
a
a
a
K
u
a
t
t
a
a
a
a
u
a
a
a
a
a
a
a
a
a
a
a
D
a
a
a
a
a
a
a
a
Y
M
M
Z
a
a
a
a
a
a
a
a
a
a
a
a
a
a
a
a
a
a
a
a
a
a
a
"}
(31,1,1) = {"
a
S
S
a
a
a
a
a
a
a
a
a
a
a
a
a
a
a
a
a
u
a
T
a
a
a
a
a
a
O
a
a
u
a
n
a
T
t
a
a
a
a
a
a
D
a
a
a
a
a
a
a
a
Y
M
M
Z
a
a
a
a
a
a
a
a
a
a
a
a
a
a
a
a
a
a
a
a
a
a
a
"}
(32,1,1) = {"
a
S
a
a
a
a
a
a
a
a
a
a
a
a
a
a
a
a
a
a
a
t
a
a
a
O
p
a
a
a
L
a
a
a
a
a
a
a
a
t
a
a
a
a
D
a
a
a
a
a
a
a
a
Y
M
M
Z
a
a
a
a
a
a
a
a
a
a
a
a
a
a
a
a
a
a
a
a
a
a
a
"}
(33,1,1) = {"
a
S
a
a
a
a
a
a
a
a
a
a
a
a
a
a
a
a
n
a
O
t
a
p
a
a
a
a
u
u
a
K
a
a
t
a
O
u
a
a
a
a
a
a
D
a
a
a
a
a
a
a
a
Y
M
M
Z
a
a
a
a
a
a
a
a
a
a
a
a
a
a
a
a
a
a
a
a
a
a
a
"}
(34,1,1) = {"
a
S
S
a
a
a
a
a
a
a
a
a
a
a
a
a
n
R
a
a
a
a
a
a
a
u
a
a
a
a
T
a
a
T
t
a
a
u
a
a
a
a
a
a
D
a
a
a
a
a
a
a
a
Y
M
M
Z
a
a
a
a
a
a
a
a
a
a
a
a
a
a
a
a
a
a
a
a
a
a
a
"}
(35,1,1) = {"
a
a
S
a
a
a
a
a
a
a
a
a
a
a
a
a
t
a
a
a
a
n
a
a
a
a
a
O
a
a
a
a
p
a
a
u
a
a
a
a
a
a
a
a
D
a
a
a
a
a
a
a
a
Y
M
M
Z
a
a
a
a
a
a
a
a
a
a
a
a
a
a
a
a
a
a
a
a
a
a
a
"}
(36,1,1) = {"
a
a
S
S
a
a
a
a
a
a
O
a
a
a
t
O
a
a
a
a
a
a
a
a
a
a
a
a
a
u
a
a
a
t
a
a
a
a
t
t
a
a
a
a
D
a
a
a
a
a
a
a
a
Y
M
M
Z
a
a
a
a
a
a
a
a
a
a
a
a
a
a
a
a
a
a
a
a
a
a
a
"}
(37,1,1) = {"
a
a
a
S
S
n
u
a
t
a
t
a
a
u
a
a
a
p
p
a
a
a
a
a
a
T
a
t
a
a
a
p
a
a
a
a
n
a
a
a
a
a
a
a
D
a
a
a
a
a
a
a
a
Y
M
M
Z
a
a
a
a
a
a
a
a
a
a
a
a
a
a
a
a
a
a
a
a
a
a
a
"}
(38,1,1) = {"
a
a
a
a
S
a
p
t
O
a
a
a
a
a
a
u
a
a
a
u
a
a
u
a
a
n
a
a
a
a
a
a
a
t
O
R
a
a
a
a
a
a
a
a
D
a
a
a
a
a
a
a
a
Y
M
M
Z
a
a
a
a
a
a
a
a
a
a
a
a
a
a
a
a
a
a
a
a
a
a
a
"}
(39,1,1) = {"
a
a
a
a
a
a
p
a
a
a
p
p
a
a
a
a
a
a
a
a
a
a
a
a
O
a
n
T
a
a
O
a
a
a
a
a
H
t
T
t
a
a
a
a
D
a
a
a
a
a
a
a
a
Y
M
M
Z
a
a
a
a
a
a
a
a
a
a
a
a
a
a
a
a
a
a
a
a
a
a
a
"}
(40,1,1) = {"
a
a
a
a
a
a
p
a
u
a
a
a
u
a
a
a
a
a
n
u
a
O
a
a
a
a
u
a
a
a
a
a
u
a
T
a
L
a
a
a
a
a
a
a
D
a
a
a
a
a
a
a
a
Y
M
M
Z
a
a
a
a
a
a
a
a
a
a
a
a
a
a
a
a
a
a
a
a
a
a
a
"}
(41,1,1) = {"
a
a
a
a
S
p
a
a
a
a
a
a
a
a
a
t
a
a
a
T
a
a
a
a
p
a
a
a
a
a
a
a
u
u
u
a
a
a
O
u
a
a
a
a
D
a
a
a
a
a
a
a
a
Y
M
M
Z
a
a
a
a
a
a
a
a
a
a
a
a
a
a
a
a
a
a
a
a
a
a
a
"}
(42,1,1) = {"
a
a
a
S
S
a
a
a
a
a
a
n
u
a
t
a
a
a
a
a
L
a
a
t
a
a
a
p
a
a
a
a
a
a
a
a
a
a
a
u
a
a
a
a
D
a
a
a
a
a
a
a
a
Y
M
M
Z
a
a
a
a
a
a
a
a
a
a
a
a
a
a
a
a
a
a
a
a
a
a
a
"}
(43,1,1) = {"
a
a
a
S
a
a
u
a
t
a
a
a
T
a
O
a
a
a
a
a
K
u
a
t
t
a
a
a
a
O
a
a
a
a
p
a
a
u
a
a
a
a
a
a
D
a
a
a
a
a
a
a
a
Y
M
M
Z
a
a
a
a
a
a
a
a
a
a
a
a
a
a
a
a
a
a
a
a
a
a
a
"}
(44,1,1) = {"
a
a
a
S
S
a
a
t
a
a
a
a
a
L
a
a
a
u
a
T
a
a
a
a
a
a
O
a
a
a
a
u
a
a
a
t
a
a
a
a
a
a
a
a
D
a
a
a
a
a
a
a
a
Y
M
M
Z
a
a
a
a
a
a
a
a
a
a
a
a
a
a
a
a
a
a
a
a
a
a
a
"}
(45,1,1) = {"
a
a
a
a
S
n
a
O
a
a
a
a
a
K
a
a
a
a
t
a
a
a
O
p
a
a
a
L
a
a
a
a
a
p
a
a
a
a
n
a
a
a
a
a
D
a
a
a
a
a
a
a
a
Y
M
M
Z
a
a
a
a
a
a
a
a
a
a
a
a
a
a
a
a
a
a
a
a
a
a
a
"}
(46,1,1) = {"
a
a
a
a
S
p
a
a
a
a
u
a
T
a
a
n
a
O
t
a
p
a
a
a
a
u
u
a
a
t
a
a
a
a
a
t
O
R
a
a
a
a
a
a
D
a
a
a
a
a
a
a
a
Y
M
M
Z
a
a
a
a
a
a
a
a
a
a
a
a
a
a
a
a
a
a
a
a
a
a
a
"}
(47,1,1) = {"
a
a
a
S
S
t
a
a
a
a
a
t
a
a
a
O
p
a
a
a
L
a
a
a
a
a
a
a
a
t
a
a
O
a
a
a
a
a
H
t
a
a
a
a
D
a
a
a
a
a
a
a
a
Y
M
M
Z
a
a
a
a
a
a
a
a
a
a
a
a
a
a
a
a
a
a
a
a
a
a
a
"}
(48,1,1) = {"
a
a
a
S
a
a
a
a
n
a
O
t
a
p
a
a
a
a
u
u
a
K
a
a
t
a
O
u
a
a
t
a
a
a
u
a
T
a
L
a
a
a
a
a
D
a
a
a
a
a
a
a
a
Y
M
M
Z
a
a
a
a
a
a
a
a
a
a
a
a
a
a
a
a
a
a
a
a
a
a
a
"}
(49,1,1) = {"
a
a
S
S
a
a
a
R
a
a
a
a
a
a
a
u
a
a
a
a
T
a
a
T
t
a
a
u
a
a
a
a
a
a
u
u
u
a
a
a
a
a
a
a
D
a
a
a
a
a
a
a
a
Y
M
M
Z
a
a
a
a
a
a
a
a
a
a
a
a
a
a
a
a
a
a
a
a
a
a
a
"}
(50,1,1) = {"
a
a
S
a
a
a
u
a
a
a
a
n
a
a
a
a
a
O
a
a
a
a
p
a
a
u
a
a
a
u
t
a
a
a
a
a
a
a
a
a
a
a
a
a
D
a
a
a
a
a
a
a
a
Y
M
M
Z
a
a
a
a
a
a
a
a
a
a
a
a
a
a
a
a
a
a
a
a
a
a
a
"}
(51,1,1) = {"
a
a
S
S
a
a
a
a
a
O
a
a
a
a
a
a
a
a
a
a
a
a
a
a
a
a
a
a
a
a
a
a
a
a
a
a
a
a
a
a
a
a
a
a
D
a
a
a
a
a
a
a
a
Y
M
M
Z
a
a
a
a
a
a
a
a
a
a
a
a
a
a
a
a
a
a
a
a
a
a
a
"}
(52,1,1) = {"
a
a
a
S
a
a
a
t
a
t
a
a
a
a
a
a
a
a
a
a
a
a
a
a
a
a
a
a
a
a
a
a
a
a
a
a
a
a
a
a
a
a
a
a
D
a
a
a
a
a
a
a
a
Y
M
M
Z
a
a
a
a
a
a
a
a
a
a
a
a
a
a
a
a
a
a
a
a
a
a
a
"}
(53,1,1) = {"
a
a
S
S
a
a
t
O
a
a
a
a
a
a
a
a
a
a
a
a
t
a
a
a
a
a
a
a
a
a
a
a
a
a
a
a
a
a
a
a
a
a
a
a
D
a
a
a
a
a
a
a
a
Y
M
M
Z
a
a
a
a
a
a
a
a
a
a
a
a
a
a
a
a
a
a
a
S
a
a
a
"}
(54,1,1) = {"
a
a
S
a
a
a
a
a
a
p
p
a
a
a
a
a
a
T
a
t
a
a
a
a
t
a
t
t
a
a
a
a
a
a
a
a
a
a
a
a
a
a
a
a
D
a
a
a
a
a
a
a
a
Y
M
M
Z
a
a
a
a
a
a
a
a
a
a
a
a
a
a
a
a
a
a
S
S
a
a
a
"}
(55,1,1) = {"
a
a
S
S
a
a
a
u
a
a
a
u
a
a
u
a
a
n
a
a
K
L
a
u
O
a
a
a
a
a
a
a
a
a
a
a
a
a
a
a
a
a
a
a
D
a
a
a
a
a
a
a
a
Y
M
M
Z
a
a
a
a
a
a
a
a
a
a
a
a
a
a
a
a
a
a
S
a
a
a
a
"}
(56,1,1) = {"
a
a
a
S
a
t
a
a
a
a
a
a
a
a
a
a
O
a
n
T
a
a
a
u
u
a
a
a
a
a
a
a
a
a
a
a
a
a
a
a
a
a
a
a
D
a
a
a
a
a
a
a
a
Y
M
M
Z
a
a
a
a
a
a
a
a
a
a
a
a
a
a
a
a
a
a
S
a
a
a
a
"}
(57,1,1) = {"
a
a
a
S
a
t
a
a
m
a
n
u
a
O
a
a
a
a
u
a
a
u
a
a
a
a
a
a
a
a
a
a
a
a
a
a
a
a
a
a
a
a
a
a
D
a
a
a
a
a
a
a
a
Y
M
M
Z
a
a
a
a
a
a
a
a
a
a
a
a
a
a
a
a
a
S
S
a
a
a
a
"}
(58,1,1) = {"
a
a
S
S
a
a
a
t
a
a
a
T
a
a
a
a
p
a
a
a
a
a
a
a
a
t
t
a
a
a
a
a
a
a
a
a
a
a
a
a
a
a
a
a
D
a
a
a
a
a
a
a
a
Y
M
M
Z
a
a
a
a
a
a
a
a
a
a
a
a
a
a
a
a
a
S
a
a
a
a
a
"}
(59,1,1) = {"
a
a
S
a
a
a
t
a
a
a
a
a
L
a
a
t
a
a
a
p
a
a
O
a
t
a
a
a
a
a
a
a
a
a
a
a
a
a
a
a
a
a
a
a
D
a
a
a
a
a
a
a
a
Y
M
M
Z
a
a
a
a
a
a
a
a
a
a
a
a
a
a
a
a
a
S
a
a
a
a
a
"}
(60,1,1) = {"
a
a
S
S
a
u
O
a
a
a
a
a
K
u
a
t
t
a
a
a
a
u
a
a
a
a
a
a
a
a
a
a
a
a
a
a
a
a
a
a
a
a
a
a
D
a
a
a
a
a
a
a
a
Y
M
M
Z
a
a
a
a
a
a
a
a
a
a
a
a
a
a
a
a
a
S
a
a
a
a
a
"}
(61,1,1) = {"
a
a
a
S
a
a
a
a
a
u
a
T
a
a
a
a
a
a
O
a
a
u
a
n
a
T
t
a
a
a
a
a
a
a
a
a
a
a
a
a
a
a
a
a
D
a
a
a
a
a
a
a
a
Y
M
M
Z
a
a
a
a
a
a
a
a
a
a
a
a
a
a
a
a
a
S
a
a
a
a
a
"}
(62,1,1) = {"
a
a
a
S
a
a
a
a
a
a
t
a
a
a
O
p
a
a
a
L
a
a
a
a
a
a
a
a
t
a
a
a
a
a
a
a
a
a
a
a
a
a
a
a
D
a
a
a
a
a
a
a
a
Y
M
M
Z
a
a
a
a
a
a
a
a
a
a
a
a
a
a
a
a
a
S
a
a
a
a
a
"}
(63,1,1) = {"
a
a
S
S
a
a
a
n
a
O
t
a
p
a
a
a
a
u
u
a
K
a
a
t
a
O
u
a
a
a
a
a
a
a
a
a
a
a
a
a
a
a
a
a
D
a
a
a
a
a
a
a
a
Y
M
M
Z
a
a
a
a
a
a
a
a
a
a
a
a
a
a
a
a
a
S
a
a
a
a
a
"}
(64,1,1) = {"
a
a
S
a
a
n
R
a
a
a
a
a
a
a
u
a
a
a
a
T
a
a
T
t
a
a
u
a
a
a
a
a
a
a
a
a
a
a
a
a
a
a
a
a
D
a
a
a
a
a
a
a
a
Y
M
M
Z
a
a
a
a
a
a
a
a
a
a
a
a
a
a
a
a
a
S
a
a
a
a
a
"}
(65,1,1) = {"
a
a
S
a
a
t
a
a
a
a
n
a
a
a
a
a
O
a
a
a
a
p
a
a
u
a
a
a
a
a
a
a
a
a
a
a
a
a
a
a
a
a
a
a
D
a
a
a
a
a
a
a
a
Y
M
M
Z
a
a
a
a
a
a
a
a
a
a
a
a
a
a
a
a
a
S
a
a
a
a
a
"}
(66,1,1) = {"
a
a
S
S
a
a
a
t
t
a
a
a
a
p
a
a
a
a
u
a
a
a
t
a
a
a
a
t
t
a
a
a
a
a
a
a
a
a
a
a
a
a
a
a
D
a
a
a
a
a
a
a
a
Y
M
M
Z
a
a
a
a
a
a
a
a
a
a
a
a
a
a
a
a
S
S
a
a
a
a
a
"}
(67,1,1) = {"
a
a
a
S
a
a
a
a
a
a
a
p
a
a
a
t
a
a
a
a
p
a
a
a
a
n
a
a
a
a
a
a
a
a
a
a
a
a
a
a
a
a
a
a
D
a
a
a
a
a
a
a
a
Y
M
M
Z
a
a
a
a
a
a
a
a
a
a
a
a
a
a
a
a
S
a
a
a
a
a
a
"}
(68,1,1) = {"
a
a
S
S
a
u
p
p
a
O
a
a
a
a
a
a
t
a
a
a
a
a
t
O
R
a
a
a
a
a
a
a
a
a
a
a
a
a
a
a
a
a
a
a
D
a
a
a
a
a
a
a
a
Y
M
M
Z
a
a
a
a
a
a
a
a
a
a
a
a
a
a
a
a
S
a
a
a
a
a
a
"}
(69,1,1) = {"
a
a
S
a
a
a
a
a
u
a
T
a
O
u
a
a
t
a
a
O
a
a
a
a
a
H
t
T
t
a
a
a
a
a
a
a
a
a
a
a
a
a
a
a
D
a
a
a
a
a
a
a
a
Y
M
M
Z
a
a
a
a
a
a
a
a
a
a
a
a
a
a
a
a
S
S
a
a
a
a
a
"}
(70,1,1) = {"
a
a
S
a
a
a
a
a
a
a
a
T
a
a
a
a
a
t
a
a
a
u
a
T
a
L
a
a
a
a
a
a
a
a
a
a
a
a
a
a
a
a
a
a
D
a
a
a
a
a
a
a
a
Y
M
M
Z
a
a
a
a
a
a
a
a
a
a
a
a
a
a
a
a
a
S
a
a
a
a
a
"}
(71,1,1) = {"
a
S
S
a
a
a
a
a
u
a
n
a
p
a
a
a
a
a
a
a
a
u
u
u
a
a
a
O
u
a
a
a
a
a
a
a
a
a
a
a
a
a
a
a
D
a
a
a
a
a
a
a
a
Y
M
M
Z
a
a
a
a
a
a
a
a
a
a
a
a
a
a
a
a
a
S
a
a
a
a
a
"}
(72,1,1) = {"
a
S
a
a
a
a
p
a
a
a
a
a
p
p
p
a
u
t
a
a
a
a
a
a
a
a
a
a
u
a
a
a
a
a
a
a
a
a
a
a
a
a
a
a
D
a
a
a
a
a
a
a
a
Y
M
M
Z
a
a
a
a
a
a
a
a
a
a
a
a
a
a
a
a
a
S
a
a
a
a
a
"}
(73,1,1) = {"
a
S
S
a
a
a
a
w
a
a
a
a
n
a
a
a
a
a
O
a
a
a
a
p
a
a
u
a
a
a
a
a
a
a
a
a
a
a
a
a
a
a
a
a
D
a
a
a
a
a
a
a
a
Y
M
M
Z
a
a
a
a
a
a
a
a
a
a
a
a
a
a
a
a
S
S
a
a
a
a
a
"}
(74,1,1) = {"
a
a
S
a
a
a
L
a
a
t
t
a
a
a
a
p
a
a
a
a
u
a
a
a
t
a
a
a
a
a
a
a
a
a
a
a
a
a
a
a
a
a
a
a
D
a
a
a
a
a
a
a
a
Y
M
M
Z
a
a
a
a
a
a
a
a
a
a
a
a
a
a
a
a
S
a
a
a
a
a
a
"}
(75,1,1) = {"
a
a
S
a
a
a
a
a
a
a
a
a
a
p
a
a
a
t
a
a
a
a
p
a
a
a
a
n
a
a
a
a
a
a
a
a
a
a
a
a
a
a
a
a
D
a
a
a
a
a
a
a
a
Y
M
M
Z
a
a
a
a
a
a
a
a
a
a
a
a
a
a
a
S
S
a
a
a
a
a
a
"}
(76,1,1) = {"
a
a
S
a
a
a
a
u
p
p
a
O
a
a
a
a
a
a
t
a
a
a
a
a
t
O
R
a
a
a
a
a
a
a
a
a
a
a
a
a
a
a
a
a
D
a
a
a
a
a
a
a
a
Y
M
M
Z
a
a
a
a
a
a
a
a
a
a
a
a
a
a
a
S
a
a
a
a
a
a
a
"}
(77,1,1) = {"
a
a
S
S
a
a
a
a
a
a
u
a
T
a
O
u
a
a
t
a
a
O
a
a
a
a
a
H
t
a
a
a
a
a
a
a
a
a
a
a
a
a
a
a
D
a
a
a
a
a
a
a
a
Y
M
M
Z
a
a
a
a
a
a
a
a
a
a
a
a
a
a
a
S
a
a
a
a
a
a
a
"}
(78,1,1) = {"
a
a
a
S
S
u
a
a
a
a
a
a
a
T
a
a
a
a
a
t
a
a
a
u
a
T
a
L
a
a
a
a
a
a
a
a
a
a
a
a
a
a
a
a
D
a
a
a
a
a
a
a
a
Y
M
M
Z
a
a
a
a
a
a
a
a
a
a
a
a
a
a
a
S
a
a
a
a
a
a
a
"}
(79,1,1) = {"
a
a
a
a
S
a
a
a
a
a
u
a
n
a
p
a
a
a
a
a
a
a
a
u
u
u
a
a
a
a
a
a
a
a
a
a
a
a
a
a
a
a
a
a
D
a
a
a
a
a
a
a
a
Y
M
M
Z
a
a
a
a
a
a
a
a
a
a
a
a
a
a
a
S
a
a
a
a
a
a
a
"}
(80,1,1) = {"
a
a
a
a
S
S
S
p
p
a
a
a
a
a
p
p
p
a
u
t
a
a
a
a
a
a
a
a
a
a
a
a
a
a
a
a
a
a
a
a
a
a
a
a
D
a
a
a
a
a
a
a
a
Y
M
M
Z
a
a
a
a
a
a
a
a
a
a
a
a
a
a
a
S
S
a
a
a
a
a
a
"}
(81,1,1) = {"
a
a
a
a
a
a
S
S
S
S
S
a
a
a
a
a
S
S
a
S
S
a
a
a
a
a
a
a
a
a
a
a
a
a
a
a
a
a
a
a
a
a
a
a
D
a
a
a
a
a
a
a
a
Y
M
M
Z
a
a
a
a
a
a
a
a
a
a
a
a
a
a
a
a
S
a
a
a
a
a
a
"}
(82,1,1) = {"
a
a
a
a
a
a
a
a
a
a
S
S
S
a
S
S
S
a
a
a
S
a
a
a
a
a
a
S
S
S
S
S
a
a
a
S
S
S
a
a
a
a
a
a
D
a
a
a
a
a
a
a
a
Y
M
M
Z
a
a
a
a
a
a
a
a
a
a
a
a
a
a
a
a
S
a
a
a
a
a
a
"}
(83,1,1) = {"
a
a
a
a
a
a
a
a
a
a
a
a
S
S
S
a
a
a
a
a
S
S
S
a
a
S
S
S
a
a
a
S
S
S
S
S
a
S
S
S
S
S
S
S
v
a
a
a
a
a
a
a
a
Y
M
M
Z
a
a
a
a
a
a
a
a
a
a
a
a
a
a
a
S
S
a
a
a
a
a
a
"}
(84,1,1) = {"
a
a
a
a
a
a
a
a
a
a
a
a
a
a
a
a
a
a
a
a
a
a
S
S
S
S
a
a
a
a
a
a
a
a
a
a
a
a
S
a
a
a
a
S
S
S
a
a
a
a
a
a
a
Y
M
M
Z
a
a
a
a
a
S
a
a
a
a
a
a
a
a
S
S
a
a
a
a
a
a
a
"}
(85,1,1) = {"
a
a
a
a
a
a
a
a
a
a
a
a
a
a
a
a
a
a
a
a
a
a
a
a
a
a
a
a
a
a
a
a
a
a
a
a
a
a
a
a
a
a
a
a
a
S
S
S
S
a
a
a
a
Y
M
M
Z
a
a
a
S
S
S
S
S
S
a
a
S
S
S
S
a
a
a
a
a
a
a
a
"}
(86,1,1) = {"
a
a
a
a
a
a
a
a
a
a
a
a
a
a
a
a
a
a
a
a
a
a
a
a
a
a
a
a
a
a
a
a
a
a
a
a
a
a
a
a
a
a
a
a
a
a
a
a
S
S
S
v
v
r
M
M
G
v
v
S
S
a
a
a
a
S
S
S
S
a
a
a
a
a
a
a
a
a
a
a
"}
(87,1,1) = {"
a
a
a
a
a
a
a
a
a
a
a
a
a
a
a
a
a
a
a
a
a
a
a
a
a
a
a
a
a
a
a
a
a
a
a
a
a
a
a
a
a
a
a
a
a
a
a
a
a
a
a
v
E
P
M
M
x
j
v
a
a
a
a
a
a
a
a
a
a
a
a
a
a
a
a
a
a
a
a
a
"}
(88,1,1) = {"
a
a
a
a
a
a
a
a
a
a
a
a
a
a
a
a
a
a
a
a
a
a
a
a
a
a
a
a
a
a
a
a
a
a
a
a
a
a
a
a
a
a
a
a
a
a
a
a
a
a
a
v
i
P
M
M
x
i
v
a
a
a
a
a
a
a
a
a
a
a
a
a
a
a
a
a
a
a
a
a
"}
(89,1,1) = {"
a
a
a
a
a
a
a
a
a
a
a
a
a
a
a
a
a
a
a
a
a
a
a
a
a
a
a
a
a
a
a
a
a
a
a
a
a
a
a
a
a
a
a
a
a
a
a
a
a
a
a
v
J
P
M
M
x
i
v
a
a
a
a
a
a
a
a
a
a
a
a
a
a
a
a
a
a
a
a
a
"}
(90,1,1) = {"
a
a
a
a
a
a
a
a
a
a
a
a
a
a
a
a
a
a
a
a
a
a
a
a
a
a
a
a
a
a
a
a
a
a
a
a
a
a
a
a
a
a
a
a
a
a
a
a
a
a
a
v
J
P
M
M
x
i
v
a
a
a
a
a
a
a
a
a
a
a
a
a
a
a
a
a
a
a
a
a
"}
